            #####
#############   ############
#             $          @ #
# ############. #####  #####
#  $ . #   $.####...#$ #.*.#
#.  $    #.$ #  $$  # $#   #
###########  # $   ##..# $ #
#            #  #### ##  $ #
#  # $$ # ####          ## #
# $ #   ..#   ###  #####   #
#   ####### # .    .#  #   #
#  #    #   ##### $ #  #   #
# $#  $ $ #  #  .#$ # $# ###
#. #      # $$$  #  # $   .#
#.     #..#    ..#  #.$   .#
######################  ####
                     #### 
; 1

